
SO ./txt/0S.xpm
WE ./txt/0S.xpm
EA ./txt/0S.xpm
NO ./txt/0S.xpm

F 0,0,0
C 255,255,255

11111111111
11111111111
100000000001
100000000001
111111S11111
100000000011
100000000011
111111111111
