		  NO		   ./txt/fire.xpm
 		EA       ./txt/metal.xpm
	SO ./txt/scary_wall.xpm
WE ./txt/rock.xpm
F 0,0,0
C 255,255,255

1N11
1111
1111