		  NO		   ./txt/fire.xpm
 		EA       ./txt/metal.xpm
				SO ./txt/scary_wall.xpm
  		WE		 	 	 ./txt/rock.xpm
F  	  0,0,0
		   C 255,255,255



1111111111111111111111111111111111111
        10000000001100000000000011111111
        10110000011100000000N00000000001
        10010000000000000000000000000001
1111111110110000011100000000000011111111
100000000011000001110111101111111
11111111111111111111111111111111