NO ./txt/fire.xpm2
NO1 ./txt/metal.xpm
EA ./txt/metal.xpm
SO ./txt/scary_wall.xpm
WE ./txt/metal.xpm


F 0,0,0
C 255,255,255

111111111
10S0111111111111111111111111111111111111111111111111                  
10111011111111
