
SO ./txt/metal.xpm
WE ./txt/rock.xpm
EA ./txt/plank.xpm
NO ./txt/weird.xpm

F 0,0,0
C 255,255,0

11111111111
11111111111
100010000001
100000000001
1000N000001011
100000000111
100000000011
100000000011
100000000011
100000000011
100000000011
111111111111
