NO ./txt/scary_wall2.xpm
SO ./txt/scary_wall.xpm
WE ./txt/metal.xpm
EA ./txt/plank.xpm

C 255,255,255

F 0,0,0
11111111111
11111111111
1000100000011111111111111111111111111111
10000111111111111111111111111111111111111111111000001111111111
101000000000000000111111111111111111111111111111111111
11111000011111111111111111111111111111111111111111111111111111
1000S000001011111111
100000000111
10000000011
100000000011
100000000011
100000000011
100000000011
111111111111
