
SO ./txt/metal.xpm
WE ./txt/metal.xpm
EA ./txt/metal.xpm
NO ./txt/metal.xpm

F 0,0,0
C 255,255,0

11111111111
11111111111
100000000001
100000000001111111111111111111111
10000000000S000000000000000001
100000000011111111111111111111
100000000011
111111111111
