
SO ./txt/metal.xpm
WE ./txt/rock.xpm
EA ./txt/plank.xpm
NO ./txt/metal.xpm

F 0,0,0
C 255,255,255

11111111111
11111111111
100010000001
100000000001111111111
101000000000000000111111111111111111111111111111111111
11111000011111111111111111111111111111111111111111111111111111
1000S000001011111111
100000000111
10000000011
100000000011
100000000011
100000000011
100000000011
111111111111
