NO ./txt/fire.xpm
NO1 ./txt/fire1.xpm
NO2 ./txt/fire2.xpm
NO3 ./txt/fire3.xpm
SO ./txt/scary_wall.xpm
WE ./txt/metal.xpm
EA ./txt/plank.xpm


C 255,255,255

F 0,0,0
11111111111111111111111
1000000000000000111111                   
11S111111111111111111111
11111111
111111
11111
11111
11111111