			NO 				./txt/fire.xpm
	EA ./txt/metal.xpm
SO   	./txt/scary_wall.xpm
		WE                  	    		   			./txt/rock.xpm
		F  255,23,255   
C         0,5,20


111111111111111111
11
111111111111111111
110000000111111111111111
111111000N0001111
1111111111111111111111111111111111111111
