		  NO		   ./txt/fire.xpm
 		EA       ./txt/metal.xpm
	SO ./txt/scary_wall.xpm
WE ./txt/rock.xpm
F 0,0,0
C 255,255,255

1111111
11110N111
111111111