NO ./txt/fire.xpm
EA ./txt/metal.xpm
SO ./txt/scary_wall.xpm
WE ./txt/rock.xpm
F 255,23,255   
C 0,5,20



111111111
100000001
100000001
10000000111111111111111111111111111
100000000000000000000000000000000011
1000000010000000000000000000000001
100000001111111110000000000000001
1000000010000N000000000000000001
11111111100000000111111111111111
         111111111
11111111
1
1111

