NO ./tex/weird.xpm
SO ./tex/metal.xpm
WE ./tex/rock.xpm
EA ./tex/plank.xpm

F 30,20,10
C 200,225,250








11
        1111111111111111111111111
        10000000001100000000000011111111
        10110000011100000000000000000001
        10010000000000000000000000000001
1111111110110000011100000000000011111111
100000000011000001110111101111111
1111011111111101110000001N001
11110111111111011101010010001
11000000110101011100000010001
10000000000000001100000010001
111111111111111111111111111111
1111111111111111111111111111
10000000000000001101010010001
1100000111010101111101111010111
11110111 1110101 101111000001
11111111 1111111 111111111111
