NO ./txt/weird.xpm
SO ./txt/metal.xpm
WE ./txt/rock.xpm
EA ./txt/plank.xpm

F 30,20,10
C 200,225,250








        111111111111111111111111
        10000000001100000000000011111111
        10110000011100000000N00000000001
        10010000000000000000000000000001
1111111110110000011100000000000011111111
100000000011000001110111101111111
11111111111111111111111111111111
