NO ./txt/rock.xpm
SO ./txt/rock.xpm
WE ./txt/rock.xpm
EA ./txt/rock.xpm

F 10,20,30
C 150,200,250

1111111111111111111111111111111
1000000000000000000000000000001
10111111111111111111N1111111101
1010111111111111111111111110101
1010111111111111111111111110101
1010000000000000000000000000101
1010111111111111111111111110101
1010100000000000000000000010101
1010101111111111111111111010101
1010101000000000000000001010101
1010101011111111111111101010101
1010101010000000000000101010101
1010101010111111111110101010101
1010101010100000000010101010101
1010101010101111111010101010101
1010101010101000001010101010101
1010101010101011101010101010101
1010101010101000101010101010101
1010101010101011101010101010101
1010101010101000001010101010101
1010101010101111111010101010101
1010101010100000000010101010101
1010101010111111111110101010101
1010101010000000000000101010101
1010101011111111111111101010101
1010101000000000000000001010101
1010101111111111111111111010101
1010100000000000000000000010101
101011111111111111111111111010111111111
101000000000000000000000000010100000001
101111111111111111111111111110101000001
100000000000000000000000000000101000001
111111111111111111111111111111111111111
